 0             0            -1             0 
 1             0             1             2 
 20            0             1             2 
 23            0             1             2 
 1             1             1             2 
 20            1             1             2 
 23            1             1             2 
 20            2             1             2 
 23            2             1             2 
 1             3             1             2 
 20            3             1             2 
 23            3             1             2 
 1             4             1             2 
 23            4             1             2 
 16            5             8             0 
 17            5             8             0 
 18            5             10            2 
 19            5             10            2 
 20            5             1             2 
 21            5             1             2 
 22            5             1             2 
 23            5             1             2 
 1             6             1             2 
 10            6             1             2 
 11            6             1             2 
 12            6             1             2 
 13            6             1             2 
 9             7             1             2 
 0             8             1             2 
 1             8             1             2 
 2             8             1             2 
 3             8             1             2 
 4             8             1             2 
 5             8             1             2 
 6             8             1             2 
 7             8             1             2 
 8             8             1             2 
