 0             0            -1             0 
 9             0             1             2 
 0             1             1             2 
 1             1             1             2 
 8             1             36            0 
 9             1             1             2 
 1             2             1             2 
 2             2             1             2 
 8             2             36            0 
 9             2             1             2 
 1             3             1             2 
 3             3             1             2 
 8             3             36            0 
 9             3             1             2 
 1             4             1             2 
 4             4             1             2 
 8             4             36            0 
 9             4             1             2 
 1             5             1             2 
 5             5             1             2 
 8             5             36            0 
 9             5             1             2 
 1             6             1             2 
 6             6             1             2 
 9             6             1             2 
 1             7             1             2 
 7             7             1             2 
 9             7             1             2 
 1             8             1             2 
 8             8             1             2 
 9             8             1             2 
 1             9             1             2 
 9             9             1             2 
 1             10            1             2 
 2             10            1             2 
 3             10            1             2 
 4             10            1             2 
 5             10            1             2 
 6             10            1             2 
 7             10            1             2 
 8             10            1             2 
 9             10            1             2 
