 0             0             1             2 
 1             0            -1             0 
 22            0             35            0 
 23            0             1             2 
 0             1             1             2 
 23            1             1             2 
 0             2             1             2 
 23            2             1             2 
 0             3             1             2 
 3             3             26            0 
 6             3             27            0 
 23            3             1             2 
 0             4             1             2 
 23            4             1             2 
 0             5             1             2 
 1             5             21            0 
 8             5             22            0 
 23            5             1             2 
 0             6             1             2 
 3             6             18            0 
 6             6             18            0 
 14            6             29            0 
 15            6             31            0 
 16            6             31            0 
 17            6             31            0 
 18            6             31            0 
 19            6             31            0 
 20            6             31            0 
 21            6             30            0 
 23            6             1             2 
 0             7             1             2 
 1             7             1             2 
 2             7             1             2 
 3             7             1             2 
 4             7             1             2 
 5             7             1             2 
 6             7             1             2 
 7             7             1             2 
 8             7             1             2 
 9             7             28            0 
 10            7             28            0 
 11            7             28            0 
 12            7             28            0 
 13            7             28            0 
 14            7             1             2 
 15            7             1             2 
 16            7             1             2 
 17            7             1             2 
 18            7             1             2 
 19            7             1             2 
 20            7             1             2 
 21            7             1             2 
 22            7             1             2 
 23            7             1             2 
