 10            0             1             2 
 16            0             1             2 
 10            1             1             2 
 16            1             1             2 
 0             2            -1             0 
 10            2             1             2 
 16            2             1             2 
 0             3             1             2 
 1             3             1             2 
 15            3             13            0 
 1 
 15            3             2             3 
 16            3             1             2 
 16            4             1             2 
 16            5             1             2 
 16            6             1             2 
 16            7             1             2 
 16            8             1             2 
 0             9             1             2 
 1             9             1             2 
 2             9             1             2 
 3             9             1             2 
 4             9             1             2 
 5             9             1             2 
 6             9             1             2 
 7             9             1             2 
 8             9             1             2 
 9             9             1             2 
 10            9             1             2 
 11            9             1             2 
 12            9             1             2 
 13            9             1             2 
 14            9             1             2 
 15            9             1             2 
 16            9             1             2 
