 0             5            -1             0 
 4             5             103           0 
 0             6             1             2 
 1             6             1             2 
 2             6             1             2 
 3             6             1             2 
 4             6             1             2 
 5             6             1             2 
 6             6             1             2 
 7             6             1             2 
 8             6             1             2 
 9             6             1             2 
 10            6             1             2 
 11            6             1             2 
